12
1,5,7,5,5,7,5,5,7,5,5,6
3,5,13,5,5,13,5,5,13,5,5,14
11,5,5,5,5,5,5,5,5,5,5,14
11,5,5,5,5,5,5,5,5,5,5,14
11,5,5,5,5,5,5,5,5,5,5,14
11,5,5,5,4,3,6,1,5,5,5,14
11,5,5,5,4,9,14,1,5,5,5,14
11,5,5,5,5,5,13,5,5,5,5,14
11,5,5,5,5,7,7,7,5,5,5,14
11,5,5,5,5,15,15,15,5,5,5,14
11,5,5,5,5,13,13,13,5,5,5,14
9,5,5,5,5,5,5,5,5,5,5,12